10,10
0,0,0,0,0,0,0,0,0,0
0,0,0,0,0,0,0,0,0,0
0,0,0,0,0,0,0,0,0,0
0,0,5,5,5,5,3,3,4,4
0,0,5,2,2,2,5,3,4,4
0,0,5,2,2,2,5,3,4,4
0,0,5,2,2,2,5,3,4,4
0,0,5,5,5,5,3,3,4,4
0,0,0,0,0,0,4,4,4,4
0,0,0,0,0,0,4,4,4,4
